compel=tvinga
coerce=tvinga med hot(He was --- into -ing)
coercion=tvinga med hot(substantiv-form)
expire=upphöra att gälla
expiry=upphöra att gälla(substantivform)
perish=die
alleviate=lindra, mildra(used with unemployment, situation, housing shortage)
exacerbate=förvärra(--- something)
aggravate=annoy, make something worse(injury, ---ed his injury)
disintegrate=förstöra till småbitar
annihilate=omintetgöra,destroy something completely
obliterate=omintetgöra, to remove all signs of something, either by destroying or hiding
eradicate=utrota
assure=försäkra(generellt)
reassure=försäkra(lugna någon)
insure=försäkra(pengar till bil, hus, etc)
ensure=garantera, se till att
ascertain=fastställa(cause of death)
determine=fastställa(cause of death), avgöra
gauge=measure, judge(--- public opinion)
contaminate=smitta(more specific)
pollute=förorena
contravene=strida mot(avtal)
violate=to break against something, especially a law/agreement etc.
imply=innebära,antyda
entail=innebära, medföra, innefatta
involve=innebära
ensue=följa på( serious problems will ---, in the --- war)
perceive=uppfatta, notice something that is difficult to notice
discern=skönja, see something after looking at it carefully
discerning=good taste, judgement in art/music/wine
extinguish=släcka, --- all hope
quench=--- your thirst
outweigh=väger mer än något, viktigare, advantages ---ed disadvantages
offset=utjämna, kompensera, uppväga, balance the effects of s.th. so there are no advant. or disadvan.
mitigate=mildra,limit the effects, --- the damage, ---ing circumstances
purchase=buy
acquire=förvärva
thrive=frodas
flourish=frodas, company is ---ing
prosper=frodas, bli rik?
appalling=skrämmande, förförlig, hemsk
atrocious=ohygglig, avskyvärd
immaculate=perfect, perfectly clean
impeccable=perfect (--- taste/manners/credentials/record)
flawless=perfect,felfri
biased=partisk
impartial=opartisk
dumbfounded=surprised
flabbergasted=surprised,shocked by the unexpected
stunned=surprised, bedövad
devastated=förkrossad
exasperated=anger & frustration
incensed=angry
infuriated=angry
despicable=eländig, ynklig
contemptible=föraktlig, usel
abject=being extremly unhappy, in --- poverty, he offered an --- apology, an --- coward
indespensable=oumbärlig
unprecedented=never having happened or existed in the past