RNA-polymeras=enzym som är aktivt under transkriptionen
histon=protein som DNA är lindat runt vilket hjälper till att packa det tätt
deoxyribonukleinsyra=DNA
ribonukleinsyra=RNA
nukleotid=fosforylerad nukleosid
adenin=kvävebas-A
cytosin=kvävebas-C
guanin=kvävebas-G
tymin=kvävebas-T
uracil=kvävebas-U
arvsanlag=gen
kromosom=struktur i cellen som är bärare av genomet 
genom=samtliga gener
gen=En sekvens DNA som kodar för ett protein
icke-kodande DNA=DNA som inte kodar för protein
DNA=kvävebaserna A, C, G, T som sitter fast på sockerkedjor i spiralformation
RNA=Tillfällig struktur som imiterar en gen och används för att skapa protein
protein=En struktur av olika aminosyror
enzym=proteiner som katalyserar
nukleinsyra=samlingsnamn för syror som DNA och RNA
deoxiribos=sockerart i DNA
ribos=sockerart i RNA
Baspar=ett par kvävebaser
budbärar-RNA=mRNA
transfer-RNA=tRNA
ribosom-RNA=rRNA
cytoplasma=cellmassa som finns mellan cellmembrandet och cellkärnan
cellkärna=en struktur som är innesluten i ett membran och innehåller cellens arvsmassa
kodon=följd av tre kvävebaser i nukleotiderna i en RNA-molekyl
transkription=DNA avläses och mRNA bildas
translation=process där ribosomer använder RNA för att bygga protein
promotor=en sekvens av baspar framför en gen som reglerar dess uttryck
stoppkodon=ett kodon som inte kodar för ett protein
exon=del av budbärar-RNA som blir kvar till byggandet av protein
intron=del av budbärar-RNA som splitsas bort
splitsning=omvandlingen från mRNA till rRNA
antikodon=del av tRNA som binder till kodonet på mRNA
aminosyra=kemisk förening som innehåller både en amingrupp och en karboxylgrupp
ribosom=översätter mRNA till protein
