contradict=säga emot(verb)
contradictory=motsägelsefull(adjective)
contradiction=motsägande(noun)
contraception=preventivmedel(noun)
contraceptive=preventiv(adjective)
contravene=strida mot(noun)
contravention=överträdelse(noun)
contrast=differ strikingly(noun)
controversy=prolonged public disagreement or heated discussion(noun)
contraband=smuggling(noun)
interfere=ingripa, störa(verb)
intervene=ingripa, komma emellan(verb)
interrupt=avbryta, stänga(verb)
interview=conversation between two parts whe one is asking the other questions(noun)
intermission=pause, break(noun)
interval=an intervening time, space between things(noun)
interracial=mellanrasig(noun)
interpret=tolka(verb)
interpreter=tolk(noun)
intercept=hejda(verb)
previous=tidigare, föregående(adjective)
prefix=an affix placed before a word(noun)
preview=förhandsvisning(noun)
prequel=work whose story precedes that of a previous work(noun)
predominant=övervägande(adjective)
preoccupied=upptagen(adjective)
prejudice=fördom(noun)
prejudge=döma på förhand(verb)
precaution=försiktighetsåtgärd(noun)
prenuptial arrangement=contract entered into prior to marriage(noun)
predict=förutsäga(verb)
prevent=förhindra(verb)
precinct=område, distrikt(noun)
prerequisite=förutsättning(noun)
preposterous=orimlig, absurd, löjlig(adjective)
premature=för tidig, förhastad(adjective)
predecessor=företrädare(noun)
precede=föregå(verb)
subway=tunnelbana(noun)
subtitle=undertext(noun)
subtract=take away(verb)
subconscious=undermedveten(adjective)
suburb=förort(noun)
subdued=lugn, tyst, diskret(adjective)
subject=ämne, föremål, motiv(noun)
submissive=ödmjuk, underlägsen(adjective)
submarine=ubåt(noun)
submerge=sänka, doppa, täcka helt och hållet(verb)
subsequently=sedan, därefter, efteråt(adverb)
postpone=skjuta upp(verb)
post-mortem=after death()
posthumously=after the death of the originator(adverb)
postscript=additional remark, computer language for creating vector graphics(noun)
posterity=eftervärld, future generations(noun)
superficial=flack, ytlig(adjective)
superfluous=överflödig(adjective)
supervise=övervaka, kontrollera(verb)
supervision=tillsyn, övervakning, handledning(noun)
superior=överlägsen(adjective)
supersede=ersätta, efterträda(verb)
reclaim=återföra, återvinna, ta tillbaka(verb)
recoil=rekyl, ryggar(noun, verb)
reconstruct=ombilda, repair damage(verb)
recur=återkomma, periodisk(verb)
reform=make changes in an institution(verb)
refund=återbäring, återbetalning av pengar(verb)
regain=obtain possession of a quality after losing it(verb)
rejoin=återförena(verb)
recycle=återanvända(verb)
reproduce=fortplanta sig, förnya, upprepa(verb)
restrain=hindra, hålla tillbaka(verb)
resume=återuppta(verb)
retain=behålla, bevara, minnas(verb)
retract=ta tillbaka, dra in(verb)
retrieve=bring something back, find or extract(verb)
revive=återuppliva(verb)
