exorbitant=överdrivet(a much higer price than it should be)
meticulous=noggrann(very careful about small details)
diligently=flitigt(working hard and being thorough or careful)
ephemeral=kortlivad(existing or popular for only a short time)
tentatively=tvekande(done without confidence, hesitantly)
timidly=blygsamt(not having confidence or courage)
vending-machine=varuautomat(you can get chocolate, drinks etc. from it)
street-vendors=gatuförsäljare(someone who sell things)
lucrative=lönsam(earns you a lot of money)
tenuous=tunn(a situation or relationship that is uncertain, weak or likely to change)
indifferent=skit samma(lack of interest or concern)
ignorance=okunnighet(lack of knowledge or information about something)
ameliorate=förbättra(improve)
exemplary=exemplarisk(perfect)
lurid=hemsk(shocking (story or information) often involving sex)
vociferously=högljutt(noisily and loudly)
ostracised=utfryst(you refuse to accept someone as part of the group and openly ignore them)
dubious=tveksam(uncertain about something)
deterred=förhindrade(try to stop someone)
dissuade=avråda(persuade someone not to do something)
belittled=förminskade(you make someone feel small)
diminished=förminskade(to become or make something smaller or less, or make something seem less important than it is)
benevolent=välvillig, generös
exasperating=irriterande, jobbig
prudent=förståndig
enhance=förbättra, förhöja
adversity=motgång, elände
emulate=ta efter, söker överträffa
adverse=ogynnsam, fientlig, kritisk
substantiate=styrka, bevisa
ostentatious=prålig
condescending=nedlåtande
extenuating=förmildrande
superfluous=överflödig
precocious=brådmogen, tidigt utvecklad
adversary=moståndare
exonerated=frikänd, rentvådd, befriad från ansvar
barren=ofruktbar,torftig
death=brist, knapphet
appease=stilla, lugna
surreptitiously=i smyg, i hemlighet
soporific=sövande
jettison=kasta överbord
writhed=vrida sig
voracious=omåttlig, glupsk
resilience=förmåga att komma igen
impetuous=häftig, impulsiv
inaudible=ohörbar
